L,5,5
H,6,5,4,4,3,3,3,2,3,3,4,4,5
W,2,3,3,3
W,3,3,4,3
W,4,3,5,2
W,5,2,6,3
W,4,3,5,4
W,5,4,4,5
W,4,5,5,5
W,5,5,6,5
W,6,5,5,4
W,2,3,2,4
W,2,4,2,5
W,2,5,2,6
W,2,6,3,7
W,4,6,3,7
W,4,6,4,7
P,4,7,5,7
W,5,7,5,6
W,5,6,6,6
W,6,6,7,7
W,7,7,8,7
W,8,7,8,6
W,8,6,7,5
W,7,5,8,5
W,8,5,8,4
W,8,4,8,3
W,8,3,7,3
W,7,3,6,3
S,5,3,G,G,G
S,7,4,R,G,G
S,7,6,R,G,G
S,4,4,R,R,R
S,3,6,G,R,R
