P,0,1,0,2
P,0,2,0,3
W,0,3,1,4
W,0,5,1,4
P,0,6,0,5
W,0,6,1,6
W,1,6,2,5
W,2,2,3,2
W,3,2,3,3
W,3,3,2,3
W,2,3,2,2
W,4,0,3,0
W,2,6,2,5
W,2,6,3,6
W,3,6,4,6
W,3,4,4,4
S,4,1,G,G,G
W,3,4,3,5
W,3,5,4,4
S,4,3,R,R,G
W,4,6,5,5
W,5,5,5,4
W,2,1,1,1
S,4,5,R,R,G
S,1,2,G,R,G
S,1,5,R,G,R
W,5,4,5,3
W,5,3,5,2
H,4,2,5,3,5,4,6,2,6
W,5,2,5,1
W,5,1,4,0
L,3,1
W,3,0,2,1
W,1,1,0,1
